1111111111111111
1E00000000000101
1010110101100011
101010001P101001
101X10000C00C001
1111111111111111